type maze
height 45
width 168
map
@@@@@@@@@@@@@@@@@@@@@@@@@@@@@@@@@@@@@@@@@@@@@@@@@@@@@@@@@@@@@@@@@@@@@@@@@@@@@@@@@@@@@@@@@@@@@@@@@@@@@@@@@@@@@@@@@@@@@@@@@@@@@@@@@@@@@@@@@@@@@@@@@@@@@@@@@@@@@@@@@@@@@@@@
@.....@.......@.......@...............@...........@...@.@.......@...............@.@.....@.@...@.@.@...........@.......@...........@...............@.....................
@@@.@@@@@@@@@.@@@@@.@.@@@@@.@@@@@.@@@.@.@@@.@@@@@.@.@@@.@.@.@@@@@.@@@.@@@@@.@@@@@.@.@.@@@.@@@.@.@.@.@@@.@.@.@@@@@.@.@@@.@@@@@.@.@.@.@@@@@@@@@.@@@.@@@@@.@@@@@@@@@.@@@@@@
@.....@...........@.@...@.@.....@.@...@.@...@.......@...@.@.........@.@.....@.......@.@.......@.@.....@.@.@.@.....@...@.@...@.@.@.@.........@...@.@...@...@.......@.....
@.@@@@@.@.@@@@@.@@@.@@@.@.@.@@@@@@@.@@@.@.@@@@@@@@@@@.@.@.@@@@@@@@@@@.@@@.@.@.@@@@@@@.@@@@@.@.@.@.@@@.@@@.@.@.@@@@@@@@@@@.@.@@@.@.@@@@@@@@@.@@@.@.@.@.@@@@@.@@@@@@@.@@@@
@.......@.@...@...@...@...@.@.......@...@.@.........@.@.....@...@.....@.@.@.@.@...@.........@.@...@.....@.@...@...........@.....@.....@.@.....@.@...@.@.....@.....@...@.
@@@@@@@@@.@.@@@.@@@.@.@.@.@@@.@@@@@@@.@@@.@.@@@@@.@@@.@@@.@@@.@.@.@@@@@.@@@@@.@.@.@.@.@@@@@@@.@.@@@@@@@@@@@.@@@.@@@@@@@@@@@@@@@@@@@@@.@.@@@.@@@.@@@@@.@.@@@@@.@@@.@@@.@.
@...@.....@.....@...@.@.@.@...@.........@.......@.....@.@.....@.@...@.......@...@.@.@.@.....@.@.@.@.....@...@...@.......@...........@.....@.@...@.....@.......@.........
@.@.@.@@@@@.@@@@@@@.@@@@@.@.@.@.@@@@@@@@@@@@@@@@@@@@@@@.@@@@@.@@@.@@@@@.@@@.@.@@@@@.@@@.@@@.@.@@@.@@@.@.@.@.@.@@@.@@@@@.@@@.@.@@@@@@@@@@@.@@@.@@@.@@@@@@@.@@@@@@@@@@@@@.
@.@.....@...@.......@.@...@.@.@.....@.....@...@.....@.....@.@.@.....@...@.@...@.........@...@...@.....@...@.@.@.....@.....@.@.........@.@.@...@...@...@.@.@...........@.
@.@@@@@.@@@@@.@@@@@@@.@@@.@.@@@.@@@.@.@@@@@.@.@.@@@.@@@.@.@.@@@.@@@.@.@@@.@@@@@@@@@@@@@@@.@@@@@.@@@.@@@@@@@.@.@.@@@@@@@@@.@.@@@@@@@@@.@.@.@@@.@.@@@.@.@.@.@@@.@@@.@@@@@@
@...@.....@...@.@.....@...@...@.@...@.......@.@.@.@.....@.....@...@.@...@.........@.......@.@.......@.@.....@...@.@.......@.@.....@...@.@.....@.@...@.@.@.@...@...@.....
@@@.@@@@@@@@@.@.@.@@@.@.@@@@@.@@@.@@@@@@@.@@@.@.@.@@@@@.@@@@@.@@@.@@@@@.@.@@@@@@@.@.@@@@@@@.@.@@@@@@@.@.@@@@@@@@@.@.@@@@@@@.@.@.@@@.@.@.@@@@@@@.@.@@@.@.@.@@@.@.@@@.@.@@
@.........@.....@...@.@.@.........@.....@.@...@...@...@.....@...@.....@.@.@.......@.......@...@.....@...@.........@.......@...@.@...@.@.....@...@...@.@.@.@...@.@...@.@.
@.@.@@@@@.@@@@@.@@@.@@@.@@@@@.@@@@@@@.@.@@@.@@@.@@@.@.@@@@@.@.@@@@@.@@@.@@@.@.@@@@@@@@@@@.@@@@@.@@@.@@@@@.@@@.@@@.@@@.@@@@@@@@@.@.@@@.@@@@@.@@@.@@@.@.@.@.@@@.@.@.@@@.@@
@.@.@.......@...@.....@.....@.@.......@.....@...@...@...@...@...@.....@.@...@.@.@.......@.......@...@.......@...@...@.@...@.....@.@.........@.@.....@.@...@.@.@.@.@...@.
@@@@@.@@@@@.@.@@@.@@@@@@@.@@@.@@@@@@@.@.@@@.@.@@@.@@@.@.@@@@@@@.@.@@@.@.@@@.@@@.@.@@@@@@@@@@@@@@@.@@@.@@@@@@@.@@@@@@@.@.@.@@@@@@@.@.@@@@@@@.@.@.@@@@@.@.@@@.@.@.@.@@@@@.
@.....@...@.@.@.@.......@.@...........@.@.@.@...@.@.@.@.@.......@.@...@.......@.........@.......@.........@...@.......@.@.@.......@.@.....@...@.....@.@.....@.@.@...@...
@.@@@@@.@.@.@.@.@.@@@.@@@.@@@@@.@@@@@@@@@.@@@.@@@.@.@@@.@.@@@.@.@@@.@@@@@@@.@@@@@@@@@@@.@.@@@@@.@@@@@@@@@@@.@@@.@@@@@@@.@@@.@.@@@@@.@.@@@.@@@@@@@@@@@.@@@@@.@.@.@@@.@.@@
@...@.@.@...@.@...@.....@...@...@...........@...@.....@.@...@.@.@.@.....@...@.....@.....@...@...............@...@.@.@.....@.@.....@.@.@.@...........@...@...@.@.@.....@.
@@@.@.@.@@@@@.@.@@@.@@@.@@@.@@@@@.@@@@@@@@@.@@@.@@@@@.@.@@@.@@@@@.@.@@@.@.@@@.@@@.@.@@@@@@@.@@@@@@@@@@@@@.@@@.@@@.@.@@@@@.@@@@@.@.@.@.@.@@@@@@@@@@@.@@@.@@@.@@@.@@@@@@@.
@...@...@...@.@.@...@.....@.@.........@...@.....@.....@...@.....@...@.@...@...@.@.@.......@.@.........@.@.@...@...........@.....@.@.@...@.........@.....@.@.....@.@.....
@.@@@@@.@.@.@.@@@.@@@.@@@@@.@.@@@@@@@@@.@.@.@@@@@.@@@@@@@.@@@@@.@@@.@.@@@@@.@@@.@.@@@@@.@@@.@.@@@@@@@.@.@@@.@@@@@@@.@@@@@.@.@@@@@.@.@@@.@@@@@.@@@.@@@@@@@.@@@.@.@.@.@@@@
@.....@...@.@.....@.@.@.@...@.@.@.......@.@.@.....@.....@.@.@...@.@.@...@.....@.....@...@...@.@.@.......@...@.........@...@...@...@.@.@.@.....@...@...@.@.@...@...@.....
@.@.@.@@@@@@@@@.@@@.@.@.@.@@@.@.@.@@@@@@@.@.@.@@@@@.@@@@@.@.@.@@@.@.@.@@@@@@@.@@@@@.@.@@@.@@@.@.@.@@@@@@@.@@@@@.@@@.@@@@@@@.@@@@@.@.@.@.@.@@@@@@@.@.@@@.@.@@@@@@@.@@@@@.
@.@.@.@...@...@.@.@.....@.......@.@.....@.@.@.@.............@...@.@.@.....@...@...@.@...@.......@.........@.....@.........@.@.....@...@.@.....@.@.@.............@.@.....
@.@.@.@.@.@.@@@.@.@@@@@@@.@@@@@@@.@@@.@@@.@@@.@@@@@.@@@@@.@@@@@.@.@.@.@.@.@.@@@@@.@.@.@.@@@@@@@@@@@@@.@@@@@.@@@@@@@@@@@@@@@.@.@@@@@@@.@@@@@@@.@.@.@.@@@@@@@@@@@.@@@.@@@@
@.@.@.@.@...@...@.......@.@.......@.....@...@.....@...@.@.......@...@.@.@...@.......@.@.@.............@.........@...........@...@.............@.....@.........@...@.....
@.@.@.@.@.@.@@@@@.@@@.@.@@@.@@@@@@@@@@@.@@@.@@@@@.@@@@@.@@@@@@@@@.@@@@@.@@@@@@@@@@@.@@@.@.@@@@@@@@@@@@@@@@@@@.@.@.@@@@@@@@@@@@@.@@@@@@@@@@@@@@@.@@@@@.@@@.@@@.@@@.@@@.@@
@.@.@.@.@.@.......@...@...@.@...@.........@.@.....@...........@.@.@...@...@...@...@...@.@...@...............@.@...@.........@.@...@...........@...@.....@...@.@...@.@...
@@@.@@@.@@@.@@@@@@@.@@@@@@@.@@@.@.@@@.@@@@@.@.@@@.@.@@@@@.@@@.@.@.@.@.@.@@@.@@@@@.@.@@@.@@@.@.@@@@@@@@@@@@@.@@@.@@@.@@@@@.@@@.@@@.@.@@@@@@@@@.@@@@@@@@@@@@@.@@@.@@@.@.@.
@.......@.....@...@...@.....@.....@.@.@.....@...@.@.@.......@.@.@...@.@.@.................@...............@...@.@...@.@.@.@...@.............@.....@.......@...@.@.....@.
@.@.@@@@@.@.@@@@@.@@@.@@@@@.@.@@@@@.@@@.@@@@@@@.@@@.@@@@@@@.@.@.@@@@@.@.@.@@@@@@@@@@@@@@@@@@@@@@@@@@@@@@@@@@@.@.@.@@@.@.@.@.@.@@@@@@@@@@@@@@@@@@@.@.@@@@@.@.@.@.@@@.@@@.
@.@.@...@.@...@.....@.@...@.@.......@.....@.@.......@.....@.@.@.........@.........@...........................@...@...@.....@.@.....@.............@...@...@.@.@...@.@...
@@@.@.@.@@@@@@@@@.@.@.@.@.@.@@@@@.@.@@@@@.@.@@@.@@@@@.@@@.@@@.@@@.@@@@@@@@@@@@@@@.@.@@@@@.@@@@@@@@@@@@@@@@@@@@@@@@@.@.@.@@@@@@@.@@@.@.@@@@@@@@@@@@@.@@@.@@@@@.@@@.@@@.@@
@...@.@.........@.@.....@...@.....@.@...@.@.......@...@.@.@...@...@.........@...@.@.....@.@...................@...@.@.....@.......@.@.......@.......@...@...........@...
@.@.@.@@@@@@@@@.@@@@@@@@@@@@@.@@@@@.@@@.@.@.@@@@@@@.@@@.@.@.@@@@@@@.@@@.@.@@@.@.@.@@@.@@@@@@@.@@@@@@@@@@@@@@@.@@@.@.@@@@@@@.@@@@@@@.@.@@@@@.@.@@@@@@@.@@@@@.@@@@@@@@@.@@
@.@.@.@.......@...........@.@.....@.....@.@.....@...@.....@.........@.@.@.....@.@...@.......@.@.......@...@.....@...@...@...@.....@.@...@...@.@.......@.@.@.....@.....@.
@@@.@.@.@@@@@.@@@@@@@@@.@.@.@.@@@.@@@@@@@.@@@@@@@.@@@@@@@.@@@@@@@@@@@.@@@@@@@@@.@@@.@@@@@.@@@.@.@@@.@@@@@.@.@@@@@@@@@.@.@.@@@.@.@@@.@@@@@.@.@.@.@@@@@.@.@.@@@@@.@@@@@@@@
@...@.@.....@...@...@...@.@.....@.@...............@.@.@.@.@...@.@.@...@...@.....@...@...@.......@.@.@.....@...@.......@...@...@.@.....@...@.@.@.....@.@.@.....@...@.....
@.@.@.@@@.@.@@@@@.@.@@@@@.@@@@@@@.@@@.@@@@@@@@@@@@@.@.@.@.@.@.@.@.@.@.@.@.@.@.@@@.@@@.@.@@@@@@@@@.@.@@@@@.@@@.@.@@@@@@@@@@@.@@@.@@@.@@@.@.@@@.@@@@@.@@@.@@@.@@@@@.@.@@@@
@.@.@.@.@.@.@.....@.@.......@...@.....@.........@.......@...@.@...@.@.@.@...@.@.......@.@.@...@.............@.@.........@...@.......@...@...@...@...@.......@...@.@.@...
@.@@@.@.@@@.@.@@@@@.@.@@@@@@@.@.@@@@@@@.@@@.@@@@@.@.@@@.@@@@@.@.@.@.@.@.@@@@@@@@@@@@@@@@@.@.@.@@@@@@@@@@@@@@@.@.@@@@@@@.@.@@@@@@@@@@@.@@@@@.@.@@@.@@@@@.@@@.@@@.@.@.@@@@
@@@@@@@.@@@@@@@@@@@@@@@@@@@@@@@@@@@@@@@@@@@@@@@@@@@@@@@@@@@@@@@@@@@@@@@@@@@@@@@@@@@@@@@@@@@@@.@@@@@@@@@@@@@@@@@@@@@@@@@@@@@@@@@@@@@@@@@@@@@@@@@@@@@@@@@@@@@@@@@@@@@@@@@@
........................................................................................................................................................................

